11111111111111111111111111111
1P10001000100010001C001000111
1000100010C01000100010C010001
11111111111111111111111111101
1000100010C01000100010C010001
1010C010001000100010001000111
10111111111111111111111111111
1010001000100010001C001000111
1000100010C01000100010C010001
11111111111111111111111111101
1000100010C01000100010C010001
1010C010001000100010001000111
10111111111111111111111111111
10100010E0100010001C001000111
100010001001000100010C010001
11111111111111111111111111111