111111111111111111
1001001P1100000E11
1100011C1001011111
111000001011000111
111111111111111111